Ael : knight
Aer : law, order
Af : ring
Ah : crafty, sly
Al : sea
Am : swan
Ama : beauty, beautiful
An : hand
Ang : glitter
Ansr : rune
Ar : gold, golden
Ari : silver
Arn : south
Aza : life, lives
Bael : guardian
Bes : oath
Cael : archer, arrow
Cal : faith
Cas : herald
Cla : rose
Cor : legend, legendary
Cy : onyx
Dae : white
Dho : falcon
Dre : hound
Du : crescent
Eil : azure, blue
Eir : sharp
El : green
Er : boar
Ev : stag
Fera : champion
Fi : rain
Fir : dark
Fis : light
Gael : pegasus
Gar : owl
Gil : griffin
Ha : free, freedom
Hu : horse
Ia : day
Il : mist
Ja : staff
Jar : dove
Ka : dragon
Kan : eagle
Ker : spell
Keth : wind
Koeh : earth
Kor : black
Ky : ruby
La : night
Laf : moon
Lam : east
Lue : riddle
Ly : wolf
Mai : death, slayer
Mal : war
Mara : priest
My : emerald
Na : ancient
Nai : oak
Nim : deep
Nu : hope, hopeful
Ny : diamond
Py : sapphire
Raer : unicorn
Re : bear
Ren : west
Rhy / Ry : jade
Ru : dream
Rua : star
Rum : meadow
Rid : spear
Sae : wood
Seh : soft
Sel : high
Sha : sun
She : age, time
Si : cat, feline
Sim : north
Sol : history, memory
Sum : water
Syl : faerie
Ta : fox
Tahl : blade
Tha : vigil, vigilance
Tho : true, truth
Ther : sky
Thro : lore, sage
Tia : magic
Tra : tree
Ty / Try : crystal
Uth : wizard
Ver : peace
Vil : finger, point
Von : ice
Ya : bridge, path, way
Za : royal
Zy : ivory
